XXXXXXXXXXXXXXXXXXXX/
XOOOOOOOOOOOOOOOOOOX/
XOOOOOOOOOOOOOOOOOOX/
XOOOOOOOOOOOOOOOOOOX/
XOOOOOOOOOOOOOOOOOOX/
XOOOOOOOOOOOOOOOOOOX/
XOOOOOOOOOOOOOOOOOOX/
XOOOOOOOOOOOOOOOOOOX/
XOOOOOOOOOOOOOOOOOOX/
XOOOOOOOOXXOOOOOOOOX/
XOOOOOOOOXXOOOOOOOOX/
XOOOOOOOOOOOOOOOOOOX/
XOOOOOOOOOOOOOOOOOOX/
XOOOOOOOOOOOOOOOOOOX/
XOOOOOOOOOOOOOOOOOOX/
XOOOOOOOOOOOOOOOOOOX/
XOOOOOOOOOOOOOOOOOOX/
XOOOOOOOOOOOOOOOOOOX/
XOOOOOOOOOOOOOOOOOOX/
XXXXXXXXXXXXXXXXXXXX/