XXXXXXXXXXXXXXXXXXXX/
XOOOOOOOOOOOXOOOOOOX/
XOOOOOOOOOOOXOOOOOOX/
XOOOOOOOOOOOOOOOOOOX/
XOOOOOOOOOOOOOOOOOOX/
XOOOOOOOOOOOXOOOOOOX/
XOOOOOOOOOOOXOOOOOOX/
XOOOOOOOOOOOXXXOOXXX/
XOOOOOOOXOOOOOOOOOOX/
XOOOOOOOOOOOOOOOOOOX/
XOOOOOOOOOOOOOOOOOOX/
XOOOOOOOOOOOOOOOOOOX/
XXXOOXXXOOOOOOOOOOOX/
XOOOOOOXOOOOOXOOOOOX/
XOOOOOOXOOOOOOOOOOOX/
XOOOOOOOOOOOOOOOOOOX/
XOOOOOOOOOOOOOOOOOOX/
XOOOOOOXOOOOOOOOOOOX/
XOOOOOOXOOOOOOOOOOOX/
XXXXXXXXXXXXXXXXXXXX/