XXXXXXXXXXXXXXXXXXXX/
XOOOOOOOOOOOOOOOOOOX/
XOOOXXOOOOOOOOOOOOOX/
XOOOOOOOOOOOOXXOOOOX/
XOOOOOOOOOOOOXXOOOOX/
XOOOOOOOOOOOOOOOOOOX/
XOOOOXOOOOOOOOOOOOOX/
XOOOOXOOOOOOOXXOOOOX/
XOOOOXOOOOOOOXXOOOOX/
XOOOOOOOOOOOOOOOOOOX/
XOOOOOOOOOOOOOOOOOOX/
XOOOOOOOOOOOOXOOOOOX/
XOOXOOOOOOOOOXOOOOOX/
XOOXOOOOOOOOOOOOOOOX/
XOOOOOOOOOXOOOOOOOOX/
XOOOOOOOOOXOOOOOXOOX/
XOOOOOOOOOOOOOOOXOOX/
XOOXXXOOOOOOOOOOXOOX/
XOOOOOOOOOOOOOOOOOOX/
XXXXXXXXXXXXXXXXXXXX/