XXXXXXXXXXXXXXXXXXXX/
XOOOOOOOOOOOOOOOOOOX/
XOOOXXOOOOOOOOXXOOOX/
XOOOXXOOOOOOOOXXOOOX/
XOOOOOOOOOOOOOOOOOOX/
XOOOOOOOOOOOOOOOOOOX/
XOOOOOOOOOOOOOOOOOOX/
XOOOOOOOOOOOOXXXXOOX/
XOOOOOOOOOOOOOOOOOOX/
XOOOOOOOOXOOOOOOOOOX/
XOOOOOOOOXOOOOOOOOOX/
XOOOOOOOOOOOOOOOOOOX/
XOOOOOOOOOOOOOOOOOOX/
XOOOXXXXOOOOOOOOOOOX/
XOOOOOOOOOOOOOOOOOOX/
XOOOOOOOOOOOOOXXOOOX/
XOOOXXOOOOOOOOXXOOOX/
XOOOOOOOOOOOOOOOOOOX/
XOOOOOOOOOOOOOOOOOOX/
XXXXXXXXXXXXXXXXXXXX/